...##@##
...#...##.
.##...##..#
##........#
#...#..#..#
..#..###..#
..#..#....#
.##....#.##
.#......##
.#.#...##
.#.#.#.#..#